##____________________________________________________________##
##____________________________________________________________##
##____________________________________________________________##
##__________$#######################################_____#######
##_________$__________________________________________________##
####__###$____________________________________________________##
##____________________________________________________________##
##____________________________________________________________##
##____________________________________________________________##
##____________________________________________________________##
##____________________________________________________________##
##____________________________________________________________##
##_________________________$####################################
##________________________$___________________________________##
##_______________________$____________________________________##
##_______$#######__#####$%____________________________________##
##______$_________________%___________________________________##
##_____$___________________%__________________________________##
##____$_____________________%_________________________________##
################################################################ 
################################################################ 