#______________________________#
#______________________________#
#______________________________#
#______________________________#
#______________________________#
#______________________________#
#______________________________#
#______________________________#
#______________________________#
#______________________________#
#______________________________#
#______________________________#
#______________________________#
#______________________________#
#______________________________#
#_______$#######%______________#
#______$_________%_____________#
#_____$___________%____________#
#____$_____________%___________#
################################
################################