###________________________*__##
##_______________________$######
##______________*_______$_____##
##_________$#####______$______##
##+____&__$___________$_______##
####__#####%_________$________##
##__________%_______$_________##
##___________%__+__$__________##
##___________#######__________##
##____________________________##
##____________________________##
##____________________________##
##__________________________^_##
##_________________________$####
##________________________$___##
##___________+_______&___$____##
##_______$#######__#######____##
##*_____$_^___________________##
###____$______________________##
##____$________!____________*_##
################################